aaaaaaaa1111111111111111111111111
aaaaaaaa1000000000110000000000001
aaaaaaaa1011000001110000000000001
aaaaaaaa1001000000000000000000001
111111111011000001110000000000001
100000000011000001110111111111111
11110111111111011100000010001aaaa
11110111111111011101010010001aaaa
11000000110101011100000000001aaaa
10000000000000000000000000001aaaa
10000000000000001101010000001aaaa
11000001110101011111011110N0111aa
11110111a1110101a101111010001aaaa
11111111a1111111a111111111111aaaa
